OOOOOOOOOOOOOOOOOOOOOOOOOOOOOOOOOUO
OXO .  OOOOO O    O     O OOO     O
O O O  .     O    O  O  O OOO OOOOO
O O O  OOOOOOOOOO.O  O  OO.OO.O.O O 
O   O  .  .    .  .  O            O
OOOOOOOOOOOOOOOOOOOOOOOOOOOOOOOOOOO
